level 3
next_level assets/level_4.map
map
# # # # # -1
# 0 0 0 # -1
# 0 S 0 D -1
# 0 0 0 # -1
# # # # # -2