level 3
next_level assets/level_4.map
map
# # L # # -1
# 0 K 0 # -1
# 0 0 0 D -1
# 0 S 0 # -1
# # # # # -2